+-+-+-+-+-+-+-+-+-+-+-+-+-+-+-+-+-+-+-+-+-+-+-+-+-+
|     |     | |   |   | |         | |   | |     | |
+ +-+ + +-+-+ + +-+-+ + +-+ +-+ +-+ + +-+ +-+ + + +
| | | | |       |   |   |   |   | |           | | |
+ + + + +-+ +-+ + + + +-+-+ + +-+ + +-+-+ +-+ + + +
| |   | |       | |   |     |   |       | |   |   |
+-+-+ + +-+ +-+ + + + + + + +-+ +-+-+-+ + + +-+-+ +
|     | | | | |   | | | | |               |       |
+ +-+ + + + + + +-+ + +-+ +-+-+ +-+-+-+-+ +-+-+ +-+
| |     | |     |           |     | |       |     |
+ +-+ +-+ + + + +-+ +-+-+-+ + +-+ + +-+ +-+ +-+-+-+
| |       | | |         |       | |             | |
+-+ +-+ + + + +-+-+ +-+-+-+-+-+ + + +-+ +-+-+ +-+ +
|       |   |   |     |           |   |     | | | |
+ +-+-+ +-+-+-+-+ + +-+ + + +-+ +-+-+ +-+-+-+-+ + +
|     |       |   |   | | |   |   |           |   |
+-+ +-+ + +-+-+ + +-+-+ + +-+-+ +-+-+-+ +-+-+ +-+ +
| |   | |     | |   |           |   |   |         |
+ +-+ + +-+ + +-+ +-+ + + +-+ +-+ +-+-+ + +-+ +-+ +
|       |   |       | | | |   |     |   | | |   | |
+-+ +-+-+ +-+ +-+ +-+-+ +-+ +-+ + + + +-+ + + +-+-+
|         | |         |         | | |     |     | |
+-+-+-+ +-+ +-+ +-+ +-+-+ +-+ +-+ + +-+ + +-+-+ + +
|       |   |     |     |         |     |     |   |
+-+-+-+ +-+ +-+ +-+-+-+ +-+-+ +-+-+-+-+ + +-+-+-+-+
| |               | |               |             |
+ +-+ +-+-+ + +-+ + +-+-+-+ + + + + + +-+-+ +-+-+-+
| |   |     |           |   | | | |     |         |
+ + +-+-+-+ +-+ +-+ +-+-+-+ + +-+-+-+ +-+-+ +-+ +-+
| | | |     | |         |     |         |     | | |
+ + + +-+ +-+ + +-+-+-+ +-+-+ +-+-+-+ +-+ +-+ +-+ +
|       |   |           |   | |             |     |
+ + +-+-+-+-+ + +-+ +-+ + +-+-+-+-+ +-+-+-+ + +-+ +
| |   |   | | | |     |           |       |   | | |
+-+ + + +-+ + +-+-+ + +-+-+ +-+ +-+ +-+-+-+ + + +-+
|   | |         |   |     | |               |     |
+-+-+-+ + +-+-+ + + + +-+ +-+ +-+-+ + +-+ +-+-+-+-+
|       |     |   |   |   | | | | | |   |         |
+-+-+ + +-+-+ +-+-+ +-+ +-+ + + + + +-+ +-+ +-+ +-+
|     | |               | |     |         |       |
+ +-+ +-+ + +-+-+ +-+-+-+ + + +-+-+-+ +-+-+ +-+ +-+
| |     | |       |   |     |     | | |       |   |
+-+ + + +-+-+ +-+ +-+ + +-+-+ + +-+ + +-+-+-+ + +-+
| | | |       |           |   |   |   | |     |   |
+ + + +-+-+ +-+ +-+-+ + +-+ +-+ + +-+-+ + +-+ + +-+
|   |     |       | | |   | | | |                 |
+-+ +-+-+ + +-+ +-+ + + +-+-+ +-+ +-+ + +-+-+ + +-+
|                 | | |   |   |   |   | | | | |   |
+-+ +-+-+ +-+-+-+-+ + + +-+ + + +-+ +-+ + + + +-+ +
|     |           |     |   |     |   | |       | |
+-+-+-+-+-+-+-+-+-+-+-+-+-+-+-+-+-+-+-+-+-+-+-+-+-+
