+-+-+-+-+-+-+-+-+-+-+-+-+-+-+-+-+-+-+-+-+-+-+-+-+-+
|   |     |       | |   | |             | | |     |
+ +-+-+ +-+ + +-+-+ +-+ + + +-+-+ +-+-+-+ + + +-+ +
|     | |   |         |         |     |         | |
+ +-+-+ +-+ +-+ +-+ + + +-+ + +-+-+-+ +-+-+-+ +-+-+
| |                 |   |   | |         |   |   | |
+ + +-+ +-+ + + + +-+-+ +-+ +-+-+-+-+ + + +-+-+ + +
|     | |   | | |     |     |   | |   | |         |
+-+ +-+ + +-+ +-+-+-+-+ +-+-+-+ + + + + + + + + +-+
| |   |   | |               |       |   | | | |   |
+ + +-+ +-+ + + +-+ + + +-+ + +-+-+ +-+ + +-+ +-+ +
| |   | |     | |   | |             |   |   |   | |
+ +-+-+-+ +-+ + + +-+-+-+-+-+-+ +-+ +-+ + +-+-+-+-+
|       | |   |     |         |   | |             |
+ +-+-+-+ +-+-+-+ + + +-+-+ +-+ +-+-+ +-+ +-+-+-+ +
|     |       | | |               |           | | |
+ +-+-+ +-+-+-+ + + + +-+-+-+ +-+-+-+-+ +-+-+-+ +-+
|         |         | |   |         | |   |   |   |
+-+ +-+-+ + + +-+-+ +-+ +-+ +-+ +-+ + +-+ +-+ +-+ +
|   |       |   |     |   |     |   |     |       |
+ + +-+-+ +-+ +-+ +-+-+-+ +-+ +-+-+ +-+-+ + +-+-+-+
| |     |   |       |     |   | |       | |     | |
+-+-+ + + + +-+-+-+ + +-+ +-+ + + +-+-+ + +-+ +-+ +
|     |   |               |       |               |
+-+ +-+-+ + + +-+-+ +-+-+-+ +-+ +-+-+-+-+ + +-+ + +
|   | | |   |     | | |           |       | |   | |
+ +-+ + +-+ +-+-+ + + +-+-+-+-+ +-+-+-+ +-+ + +-+ +
| |   |                 | | |     |       |     | |
+-+ +-+-+ +-+ +-+-+-+-+ + + +-+-+ +-+ +-+-+-+-+ +-+
|     |   |     |             |       |   |       |
+ +-+ +-+-+-+ + + +-+ +-+-+-+-+ +-+-+ + + +-+ +-+-+
|   |     |   |   |   | |         |     |   | | | |
+-+-+ +-+-+ +-+-+ +-+ + + + +-+ +-+-+ +-+-+ + + + +
|       |       | | |     |       |   |           |
+-+-+ +-+-+ +-+-+ + + + +-+-+ +-+ +-+ + +-+-+ + + +
|   | |             | |     |       |       | | | |
+-+ + +-+-+ + +-+ +-+-+ +-+-+ + +-+ +-+-+ +-+ + +-+
|       | | | |   |         | |   |   |   |     | |
+ +-+-+ + + +-+ + + + +-+-+-+ + +-+-+ +-+ +-+-+-+ +
|       |       | | |                 |     |     |
+ +-+ +-+ + + +-+ + +-+-+ +-+-+ +-+-+-+-+ +-+-+-+ +
|   | |   | |     |           |       |           |
+-+ + + +-+-+-+ +-+-+-+ +-+-+ +-+-+-+ +-+-+ +-+ + +
|   | |   |   |   |       |     |         |   | | |
+-+-+ + + + + + + +-+-+ +-+ +-+ + +-+ +-+ + +-+ +-+
|   | | |   |   | |   | | |         | |         | |
+ + + +-+ + + + +-+ +-+-+ + +-+ + +-+ +-+-+ +-+-+ +
| |       | | | |               |     |           |
+ + +-+-+ + + +-+-+ +-+ +-+ +-+-+-+ + + +-+ +-+ + +
| |     | | |       |     |       | |     |   | | |
+-+-+-+-+-+-+-+-+-+-+-+-+-+-+-+-+-+-+-+-+-+-+-+-+-+
