+-+-+-+-+-+-+-+-+-+-+-+-+-+-+-+-+-+-+-+-+-+-+-+-+-+
|   |   |     |   | | |     | |     | | |       | |
+ +-+ +-+-+-+ + +-+ + + +-+ + +-+ +-+ + +-+-+ + + +
| | |     |           |         | |           |   |
+ + + + + + +-+ +-+-+-+ +-+ +-+-+ + +-+ +-+ +-+-+-+
|     | | | | |   |   | |             |           |
+-+-+ + +-+ + +-+-+-+ + + +-+ +-+-+-+-+-+ +-+-+-+ +
|                   |   |       |     |   | |     |
+-+ +-+-+ +-+ + +-+-+-+-+ +-+ +-+ + +-+ +-+ + + +-+
|   |       | |   |       |   |   |           |   |
+-+ + + + +-+ + +-+-+-+-+ + + +-+-+ + +-+-+ +-+ +-+
|   | | |   | | |     |     | |   | |           | |
+ + +-+ + +-+-+-+ + +-+ + + +-+ +-+-+-+-+-+ + +-+ +
| |         |     |     | |       | | |   | |     |
+ + + + +-+-+ +-+ + +-+ +-+-+-+-+ + + +-+ + + +-+-+
| | | | |     |       |     |     |   |     |   | |
+-+ +-+-+ +-+-+ + +-+ +-+-+ + +-+ + +-+ +-+ +-+ + +
|               | |   |     |   |           | |   |
+-+-+-+ +-+ +-+ +-+ + +-+-+-+ +-+-+ + + +-+-+ + +-+
|     |   |   |   | |         |   | | |       | | |
+ + +-+-+-+ + + + + +-+ + +-+-+-+ + + + +-+-+ + + +
| |         | | | |     | |   |   |     | |       |
+ +-+-+-+ +-+ +-+-+ +-+ + + +-+-+ + +-+-+ + +-+ +-+
| | |           |   |           |   |   | |   |   |
+-+ + +-+ +-+ + + +-+-+ +-+-+-+-+-+ +-+ + +-+ + +-+
|           | |     | |   |     |   | |         | |
+-+ + +-+-+ +-+ + + + + +-+-+ +-+ +-+ + + +-+-+-+ +
|   |   |     | | | |   |       |       |         |
+ + +-+ + +-+-+ +-+-+ +-+-+-+ +-+-+-+-+ + + +-+-+-+
| | |       | | |                 |       |     | |
+ +-+ + + +-+ + + + +-+ +-+ + + +-+ +-+-+-+ +-+-+ +
|   | | |         | |       | |               |   |
+-+ +-+-+-+-+ +-+ + +-+-+-+-+-+ +-+-+-+-+-+ +-+ +-+
| |         |   | |         |   |                 |
+ +-+-+-+-+ +-+ + + + +-+ +-+ +-+-+-+ +-+-+-+ +-+-+
|         |   |     |   | |     |               | |
+-+-+-+ +-+ +-+-+-+ + +-+ + +-+ +-+ +-+-+-+-+ + + +
|   |         |         | |     | |       |   |   |
+ + +-+ +-+ +-+-+ +-+-+ + + +-+ + + +-+-+ +-+ +-+ +
| |   | |           |   |             | | |   | | |
+ +-+ +-+ +-+-+ + +-+ +-+-+-+ +-+ +-+-+ + + + + + +
|   |     |   | |         | |       |     | | |   |
+-+ + + + +-+ +-+-+ +-+ +-+ + +-+-+ + +-+-+ +-+ + +
|     | | | |         |       |   |   |     |   | |
+ +-+ +-+ + + +-+-+-+ + + +-+ +-+ +-+-+ + + + +-+ +
|     | |           | | | |             | | | |   |
+ +-+ + + +-+-+-+ + +-+-+-+-+ + +-+-+-+ + + +-+-+-+
| |   |   | |   | |       |   |   |           |   |
+ +-+-+-+ + +-+ + +-+ +-+ + +-+-+-+-+ +-+ +-+-+ + +
|       |       |     |         |       |       | |
+-+-+-+-+-+-+-+-+-+-+-+-+-+-+-+-+-+-+-+-+-+-+-+-+-+
