+-+-+-+-+-+-+-+-+-+-+-+-+-+-+-+-+-+-+-+-+-+-+-+-+-+
|                   |                 |   |       |
+ + +-+-+-+-+ + +-+-+-+ +-+-+ +-+ +-+-+-+ + +-+-+ +
| |     | |   | |           | |       |     |     |
+-+ +-+ + +-+ + + +-+-+-+-+ + +-+-+-+ +-+ +-+ +-+-+
|   |       | | |       |   |         |   |       |
+-+-+-+ +-+ + + +-+ +-+ +-+ +-+ +-+ +-+-+ +-+ +-+-+
|       |   | |                         |   |   | |
+ + +-+-+-+ + +-+ +-+-+-+-+-+ +-+-+ +-+-+-+-+-+ + +
| | | |       |         |   |   |   | |     |     |
+ + + + +-+ + +-+ +-+-+ + + +-+-+ + + +-+ + +-+-+ +
| | |     | |             | | |   |       |   |   |
+ + + +-+-+ +-+ +-+-+-+ +-+ + +-+ + + +-+ +-+-+ + +
|   |       |     |               | |           | |
+ +-+ +-+ +-+-+-+-+ +-+ +-+ +-+-+ + + +-+-+-+ + +-+
|   |   | | | |     |   |     | | | | |       | | |
+-+-+-+-+ + + +-+-+ + +-+-+ + + +-+-+ +-+ +-+ +-+ +
|   |   |   |   |         | |       |         |   |
+-+ + + + +-+ + + +-+ + +-+ +-+ +-+-+-+ +-+ +-+ +-+
| |   | | |   |     | |     |       |     |       |
+ + +-+ + +-+ + +-+-+-+-+-+ + + +-+-+-+ + + + +-+-+
|         |   |       | |     |     |   |   |   | |
+ +-+-+ +-+-+-+ + +-+-+ + + +-+-+-+-+ +-+-+ +-+ + +
| |       |     | |       |   |   |   |         | |
+-+-+-+ +-+ +-+-+ + +-+ + + +-+ + +-+ + +-+-+ +-+ +
|             |   | |   | |     |       |     | | |
+-+ + +-+ +-+-+-+ + +-+ +-+-+ + +-+-+ +-+ +-+-+ + +
|   | |     |             |   |     | |     |     |
+-+-+ + + + + +-+-+ +-+-+ + +-+-+-+ +-+-+-+ +-+ +-+
| | |   | |       | | |         |   |   |         |
+ + +-+ +-+-+ +-+-+ + + +-+ + +-+-+ +-+ + + +-+ +-+
|   |       |     |   | |   | |           | |     |
+-+ + +-+ +-+-+ +-+ +-+ +-+-+-+ + +-+-+ + +-+-+-+-+
|     |           | |     |     | |     | |       |
+ + + +-+-+ +-+ +-+ + + + +-+ +-+ +-+-+ +-+-+-+ + +
| | | |               | | | |           |       | |
+-+-+-+ +-+-+ +-+-+ + +-+ + + +-+ + +-+ + + + +-+-+
| | |         |   | | |     |     |   |   | |   | |
+ + +-+-+-+ + +-+ + + + +-+ +-+ +-+-+-+-+ + +-+-+ +
| |       | |   |     |         |             |   |
+ +-+ + +-+ +-+-+-+ +-+ +-+ +-+ + +-+-+-+-+-+ +-+ +
|     | |   |             |   | |   |   |     |   |
+ +-+ + + +-+-+-+ +-+-+ + + +-+-+-+ + +-+ +-+ + + +
| | | | | |         | | |   | | |             | | |
+-+ +-+ + +-+ + +-+-+ + +-+ + + +-+ +-+ +-+ + + +-+
|             |           |     |   | |   | | |   |
+ + + +-+-+ + + +-+-+ +-+ + + +-+-+-+ +-+ + + + + +
| | |   |   |         | | | | |   |     |       | |
+ +-+-+ +-+ +-+-+-+ + + +-+ + +-+ + + +-+ + +-+ +-+
| |     |       |   |     | |       | |   | |     |
+-+-+-+-+-+-+-+-+-+-+-+-+-+-+-+-+-+-+-+-+-+-+-+-+-+
