+-+-+-+-+-+-+-+-+-+-+-+-+-+-+-+-+-+-+-+-+-+-+-+-+-+
| | |   | |     |               |             |   |
+ + + + + + + +-+ +-+-+-+ + +-+-+ + +-+-+-+-+-+ +-+
| |   | |   |   |     |   |       | |       |     |
+ + +-+-+-+ +-+ + +-+ + + +-+-+-+-+ +-+-+ + +-+ + +
|           |   | |   | |       |   |     |     | |
+-+ +-+ +-+ + + + + +-+-+ + +-+-+ + +-+ +-+ + +-+ +
|         |   |         | |       | | | | | | |   |
+ +-+ +-+ + +-+-+ +-+-+-+ + +-+-+ + + + + + + +-+ +
| |     | | | |           |     | |     |   |   | |
+ + +-+-+-+ + + +-+ +-+-+-+ + +-+ + + +-+-+-+-+-+ +
|   | | |         |     | | |   | | |       | |   |
+-+ + + + + +-+ +-+-+-+-+ + + +-+ + +-+ +-+-+ + + +
| |       | | |     |       |     |         |   | |
+ +-+-+ +-+ + + +-+-+ +-+ + +-+ + +-+ +-+-+ +-+ +-+
|   |   |     |   |       |     | |           |   |
+ +-+ +-+ +-+ +-+ +-+-+-+ +-+-+ +-+-+ +-+-+ +-+ +-+
|       |   | |         | |           | | | |   | |
+-+-+ +-+-+-+ + + + +-+-+ +-+-+ +-+ +-+ + + + +-+ +
|     |   | |   | |       |     |     |   |       |
+ +-+ +-+ + + +-+ +-+ + +-+ +-+ + +-+ +-+ +-+-+ +-+
| |     |     |       | |     | | |         |   | |
+ +-+-+-+-+ + +-+ +-+ + +-+-+ + + + +-+-+ +-+ +-+ +
| |     |   | | |   |     | | |   |   |           |
+-+-+-+ +-+-+ + +-+ +-+-+ + +-+-+ + +-+ +-+ +-+ + +
|                         |   |   |       |     | |
+-+ +-+ +-+ +-+ + +-+-+ +-+ +-+ +-+-+ +-+ + +-+-+ +
|     |   | |   |         |   |   |     |   |     |
+-+-+ + + +-+-+ +-+-+ +-+-+-+ +-+ + +-+-+ +-+ + + +
| |   | | | | |       | |   |         |   |   | | |
+ + +-+ +-+ + + + +-+ + +-+ + +-+-+ + + +-+ + + +-+
|   |   | | |   | | |               | |     |   | |
+ +-+-+ + + +-+ +-+ + +-+-+ +-+-+ +-+ +-+ +-+-+ + +
|   |     |     |     | |     |       |     | |   |
+-+ +-+ + +-+ +-+ +-+-+ + + +-+-+-+-+ + + +-+ +-+ +
|   |   |     | |   |     |         | | |       | |
+-+ + +-+-+ +-+ + + + +-+ +-+-+-+ +-+-+ +-+ +-+ + +
|               | | |   |     |   |       |   |   |
+-+-+-+-+-+ + + + +-+-+-+ +-+ + +-+-+ +-+ + +-+-+ +
| | |       | | |           | | |         |     | |
+ + + + +-+ +-+ + + +-+-+ +-+-+-+ + +-+ +-+ + + + +
| |   |         | |   | | | |     |   |     | |   |
+ +-+ + +-+ +-+ + + +-+ +-+ +-+-+-+ +-+ +-+ + + + +
|         |   |   |     |   |         | | | |   | |
+ +-+-+-+ +-+ +-+ +-+-+-+-+ + +-+-+-+ + + + +-+ + +
|   |     | |       | | |   |       | |       | | |
+ + +-+ + + + +-+-+ + + + +-+ + +-+ + +-+ +-+ + +-+
| | | | | |   |   |   |       | |           |   | |
+ + + + +-+-+ + + + + + +-+ +-+ + +-+ +-+ +-+-+ + +
| | |     |   | |   | | |   |     |     |         |
+-+-+-+-+-+-+-+-+-+-+-+-+-+-+-+-+-+-+-+-+-+-+-+-+-+
