+-+-+-+-+-+-+-+-+-+-+-+-+-+-+-+-+-+-+-+-+-+-+-+-+-+
| |     | | |   |         | |   |         |       |
+ +-+ +-+ + + +-+ +-+-+-+ + +-+ + +-+-+-+-+ +-+-+-+
|   |   |       |   |     |       |   |         | |
+-+ + + + +-+-+-+-+ + +-+ + + +-+-+-+ + +-+ +-+-+ +
|     |     | | |   | | |   |     |     |         |
+-+ +-+-+ + + + +-+ + + +-+ + +-+ +-+ +-+ + +-+ + +
|   | |   |             |   |     |   |   |   | | |
+-+ + + + +-+-+-+ +-+-+-+ +-+ +-+ +-+-+-+-+ +-+ + +
| |   | |   |           | | |     |   |     | |   |
+ +-+-+ +-+ +-+-+ + + + + + +-+ + + + + +-+ + +-+-+
|   |     |   |   | | |         |   |   | |       |
+-+ + + +-+-+ +-+ +-+-+-+-+-+ +-+ + +-+ + + +-+-+-+
| |   |                 |     |   | |       |     |
+ + +-+ + +-+-+-+-+ +-+ +-+ +-+ + + + +-+-+ +-+ +-+
| |     |     | |       |     | | |     |     |   |
+ + + +-+ +-+-+ +-+-+ + +-+ + + +-+ +-+-+ +-+-+ +-+
|   |   | |     |     |   | | |   |   |           |
+ + + +-+ +-+ + + +-+ +-+-+ +-+-+ + +-+-+ + + +-+ +
| |           |   |     |   |     | |   | | |   | |
+-+ +-+ +-+ +-+-+ +-+-+-+ + + +-+ +-+ +-+ +-+-+ +-+
| |       | |         |   |     | |               |
+ +-+-+ +-+ +-+ + +-+-+ + +-+ +-+ + +-+ +-+-+-+-+ +
|     |       | |       |   | | |   |       |   | |
+-+ +-+-+ + + + +-+-+-+-+-+ + + +-+ +-+ +-+-+ +-+-+
|         | |   |               |     |         | |
+ +-+-+-+ +-+-+-+ +-+ +-+ + + +-+-+ +-+-+-+ + +-+ +
|     |             | |   | | | |   |       | |   |
+ + +-+ +-+-+ +-+ +-+-+-+ + +-+ + +-+ +-+-+ + + + +
| |   |       |   |                   |   |     | |
+-+-+ +-+ +-+-+ + +-+-+ + +-+-+ +-+-+ + +-+ +-+ +-+
|     |     |   |   |   | |           | |     |   |
+ + +-+ +-+-+ +-+-+-+ +-+-+-+-+-+-+ +-+ + + + +-+ +
| |       |     | |                   |   | |   | |
+ + +-+-+ +-+ +-+ + + + +-+-+-+-+ +-+-+-+ +-+ +-+ +
| |           |     | |     |           | |     | |
+-+-+ +-+ + + +-+-+ + + + +-+ +-+ +-+-+-+ +-+ +-+ +
|   |     | |         | | | |           | |   | | |
+-+ +-+-+ + +-+-+ +-+-+-+-+ +-+ +-+-+ +-+ +-+ + + +
|         | |       |               | |           |
+ +-+-+-+ +-+-+ +-+-+-+-+ +-+-+-+ +-+-+-+-+-+ + + +
|           |     | | |         |     |       | | |
+ +-+ +-+-+ +-+ +-+ + + + + +-+ +-+-+-+ +-+ + +-+-+
| |   |     |   |     | | |     |   |     | |   | |
+ +-+-+-+-+ +-+ + +-+ +-+ +-+-+-+-+ + + + + + + + +
|                         |       | | | |   | | | |
+-+ +-+ +-+ +-+ +-+-+ + +-+-+ +-+-+ +-+-+ +-+ +-+ +
|   |             |   |           | | | |         |
+-+ +-+-+-+ +-+ +-+-+ +-+ +-+ +-+-+ + + + + + + +-+
|     |       |         | |               | | |   |
+-+-+-+-+-+-+-+-+-+-+-+-+-+-+-+-+-+-+-+-+-+-+-+-+-+
