+-+-+-+-+-+-+-+-+-+-+-+-+-+-+-+-+-+-+-+-+-+-+-+-+-+
|     |     |     | |   | | |   |       | |     | |
+ +-+ + + +-+ + +-+ +-+ + + +-+ +-+ +-+-+ +-+ +-+ +
| | | | | |   |     |           | | |             |
+-+ + + +-+-+ + +-+ + +-+-+-+-+ + + + +-+-+-+ +-+ +
|     |             |     |     |   |   |   |   | |
+-+ + + +-+-+ + +-+ +-+-+ +-+-+ +-+ + +-+ +-+-+-+-+
| | |         |   |   |     |             |   |   |
+ + + + +-+-+ +-+-+-+ + +-+ + +-+ +-+-+-+ + + + +-+
|     | | |   |   |     | | |           |   |   | |
+-+ + + + +-+ + +-+ +-+-+ + +-+ +-+-+-+ + +-+ +-+ +
| | |   |         | |   |   | | |     |     | |   |
+ +-+-+-+ +-+ +-+ + +-+ +-+ + + +-+ +-+-+-+-+ + +-+
|       | |                     |     |   | |     |
+-+-+ +-+-+ +-+ +-+ + +-+-+ + +-+-+ + +-+ + + +-+-+
|   |   |         | |     | |       |             |
+-+ +-+ + + + + +-+-+-+-+ +-+-+ +-+-+ + +-+-+-+ +-+
|     |   | | |       |     | |     | |   | |   | |
+-+ + + +-+ + +-+-+-+-+-+-+ + + + +-+ + + + +-+ + +
|   |     |       |     |       |   |   |         |
+ + +-+-+-+-+ +-+-+ +-+ +-+ + +-+ +-+-+ +-+-+-+-+ +
| |           |     | | |   |       |   |   |     |
+ +-+-+-+ +-+ + +-+ + + + +-+-+-+-+ +-+ +-+ +-+ + +
|   |         | | |           |     | | |     | | |
+-+ +-+ +-+ +-+-+ + +-+ +-+-+ + + +-+ +-+-+-+ + + +
| |     |   | | |     |     |   |               | |
+ +-+-+-+-+-+ + + +-+-+ + +-+ + +-+ +-+-+ +-+-+ + +
|     | |       | |   | |     |   |     |   | |   |
+-+ + + + + +-+-+ + + + +-+ +-+-+-+-+ +-+-+ + + +-+
|   |     |   |     |     |   |     | |           |
+ + + + +-+ + + + + + + +-+-+ + +-+-+-+-+ +-+-+ +-+
| |   |     |   | |   | | | | |               | | |
+ +-+ + +-+-+-+ + +-+-+ + + +-+ + +-+ + + +-+ +-+ +
| | |   |         | |     |     |     | |         |
+-+ +-+-+-+ +-+ +-+ + +-+-+-+ +-+-+-+ +-+ +-+ +-+ +
| |     |   |           |   |       | | | |     | |
+ +-+ +-+-+ + + + + +-+-+-+ + +-+-+-+-+ + + +-+ + +
| |           | | |         |           |   |   | |
+ +-+-+ +-+ +-+-+-+-+-+ +-+-+-+ + + +-+-+ + + +-+-+
| |   | |     |     |       |   | |       |       |
+ + + + +-+ + + +-+ +-+-+-+-+-+ +-+-+ + +-+ + + +-+
|   |   |   |   |       | |           |   | | |   |
+ + + +-+ +-+ +-+-+ +-+-+ +-+-+-+ +-+ +-+-+-+ +-+-+
| |         |   |       | |         |   | |   |   |
+ +-+ +-+-+ + +-+ +-+ +-+ + + +-+ +-+ +-+ + +-+ +-+
| |             | | |       | |         |         |
+ +-+-+ + + +-+-+ + + +-+ +-+-+-+-+ +-+ +-+ +-+ + +
|   |   | | | |     | |     |         |         | |
+ +-+ + + + + + +-+ +-+ + +-+-+ +-+-+ +-+-+-+ +-+ +
| |   | | |     |   |   | |         |   |         |
+-+-+-+-+-+-+-+-+-+-+-+-+-+-+-+-+-+-+-+-+-+-+-+-+-+
