+-+-+-+-+-+-+-+-+-+-+-+-+-+-+-+-+-+-+-+-+-+-+-+-+-+
|                       |       |         | |     |
+ +-+-+-+-+-+ +-+-+-+-+-+-+ +-+-+-+ +-+-+ + + +-+ +
|     |   | |       |   |       | |     |       | |
+ +-+-+-+ + + +-+-+ +-+ +-+ +-+-+ + +-+-+ +-+-+-+ +
|   | |             | |     | |       |       |   |
+-+ + +-+ + +-+-+-+ + + +-+ + + +-+ + +-+-+ +-+ + +
|   |     |     |   |     |   |     |   | |     | |
+ +-+-+ +-+-+ +-+-+-+ +-+ + +-+ +-+ + +-+ + +-+-+ +
|   | |   |             |               |       | |
+ + + +-+-+ +-+-+ + +-+-+-+ +-+ + + +-+-+-+ + + +-+
| | |   |     |   |             | |   | |   | |   |
+ +-+ + + +-+-+-+-+-+ +-+-+ + +-+-+-+ + + +-+-+-+-+
|     |   |     |   | |   | |   |     |           |
+-+ +-+ +-+-+ +-+-+ + + + + +-+ + +-+ + +-+ + +-+-+
|   |             | |   |     |     | |     |     |
+ + +-+ +-+ + +-+-+ + +-+-+ +-+-+ +-+-+-+ +-+ +-+-+
| |     |   | |   |       |   |                   |
+-+-+-+-+-+-+ + +-+ +-+ +-+-+-+ +-+-+ + + +-+-+ +-+
|         |       | |       | |   |   | | |   |   |
+-+ +-+ +-+ +-+ +-+ +-+-+-+ + +-+-+-+ + +-+ + + +-+
|           |         | |       |         | |     |
+-+ +-+ +-+ +-+ +-+-+ + +-+ +-+-+-+ +-+ + + + +-+ +
| | | | |     |   | |           |   |   |     | | |
+ +-+ + +-+ + + + + +-+-+-+-+ +-+ + + +-+-+ +-+ +-+
| |         |   | | |       |     |   |   |   |   |
+ + +-+-+ +-+-+-+ + + + +-+ +-+ +-+-+ + + + +-+-+ +
|   | | |     |     | |   |   |   |     |     |   |
+ +-+ + +-+ + +-+-+ + + +-+-+ +-+ +-+ +-+ +-+-+-+ +
|     |     | |   |       | |   |     |     | |   |
+ + +-+-+ +-+ + +-+-+ +-+ + +-+ + +-+ + +-+-+ +-+ +
| |   | |             |     |       | | | |       |
+-+ + + +-+ +-+-+ +-+ +-+-+ +-+-+ +-+-+ + + +-+-+ +
| | | |         |   |   |     |             | |   |
+ +-+ +-+-+ +-+ + +-+ +-+ +-+ +-+-+-+-+ + +-+ +-+ +
|   |       |                     |   | |     |   |
+-+ +-+-+ +-+ +-+ +-+-+-+-+-+ + +-+-+ + +-+-+-+ +-+
|       |   |     |       |   |   |       |       |
+-+-+ + +-+ + +-+ +-+ +-+-+ +-+-+ + + +-+ + + +-+-+
| |   | | | |     |     |         | | |   | |     |
+ + +-+ + +-+ +-+ +-+-+ + +-+ +-+ + +-+-+ +-+ +-+ +
|     |     | |     |           |   | |         | |
+ +-+ +-+-+-+ +-+-+ + +-+ +-+-+-+ + + +-+-+-+ +-+ +
| |       |                     | |   | |       | |
+ +-+ +-+ +-+ +-+ + +-+ +-+ +-+-+ +-+-+ + +-+-+-+ +
| |     | | |     |   | |       | |         |   | |
+-+ +-+ + + +-+-+ +-+-+ +-+-+-+ +-+-+ +-+ +-+-+ + +
| | |         | |     |       |             |   | |
+ + + +-+ + + + + + + + + +-+ +-+ +-+ + +-+ +-+ + +
|     |   | |     | |   |   | |   |   |         | |
+-+-+-+-+-+-+-+-+-+-+-+-+-+-+-+-+-+-+-+-+-+-+-+-+-+
