+-+-+-+-+-+-+-+-+-+-+-+-+-+-+-+-+-+-+-+-+-+-+-+-+-+
|     |   | |                 |       |   | |   | |
+-+ + + + + + +-+ +-+-+ +-+-+-+-+-+-+ +-+ + + +-+ +
|   |   |     |   |       |         |             |
+ +-+ +-+-+-+ +-+-+ +-+ +-+ + +-+-+ +-+ +-+-+-+-+-+
|   | |     | |             | |   | |             |
+-+-+ + +-+ + + +-+ + +-+ + + + +-+ +-+ +-+ + +-+ +
|     |   |     |   | | | | |   |         | |   | |
+ +-+ +-+-+ +-+-+ +-+ + + +-+-+ + +-+-+ +-+-+-+ + +
| |     |     | | |         |           |       | |
+ +-+-+-+ + +-+ +-+ +-+ +-+ + +-+ + +-+ +-+ +-+-+ +
|         |   | |   |             |   |           |
+-+-+ +-+-+-+-+ + + + +-+ +-+-+ +-+-+-+ +-+-+-+ +-+
|     |           | | |     |       |   |         |
+-+ +-+ +-+ +-+-+-+-+-+ + + + + +-+-+-+-+-+ +-+ +-+
| |   |     |       |   | |   |     |     | |     |
+ +-+ +-+-+ +-+ +-+ + +-+ +-+-+-+ + + +-+-+ + +-+ +
|             |             |   | |   |     | |   |
+-+ +-+-+-+-+ + +-+-+-+ +-+-+ +-+-+ +-+-+-+ + +-+ +
|   |               | | | |                 |     |
+ +-+-+-+ +-+ +-+-+-+ + + +-+-+ +-+ +-+-+ +-+ +-+ +
| | |     |     |       | |           |       |   |
+ + +-+ + +-+ +-+ +-+-+ + + + +-+ + +-+-+ +-+-+-+-+
|       |   |   |   |   | | | |   |     | |   | | |
+-+-+-+ + +-+ + + + +-+ + + +-+ +-+-+ +-+ + + + + +
| |     |     |   | | |   |         |   |   |   | |
+ +-+ + +-+ + +-+-+ + + +-+ + +-+ + + + + +-+-+ + +
| |   | |   |           |   | |   |   | |         |
+ +-+-+ +-+ +-+ + +-+ +-+-+ + + + +-+-+ + +-+-+ +-+
| | | |   | |   | |         | | |     |       |   |
+ + + +-+ + +-+ +-+-+ +-+ + + +-+-+ +-+-+ +-+-+-+-+
|       | | |     |       | |     |   | |         |
+-+ +-+-+ + + +-+-+ + +-+ + +-+-+ +-+ + + + +-+-+ +
|       |   |       |   |       | |       | |     |
+-+ +-+-+ +-+ +-+ +-+ + + +-+ +-+-+ +-+-+-+-+-+-+ +
|         | |   |     |   |     | |               |
+ +-+-+ +-+ + + + + +-+ + +-+-+-+ +-+ +-+-+ + + + +
|   |     |   | | | |   | | | |   |   |     | | | |
+-+ +-+ + + + + + +-+ +-+-+ + +-+ + +-+-+-+ + +-+-+
|       | | | |     |       |     |     |         |
+-+ +-+-+-+-+-+ +-+ + +-+-+ + +-+-+ +-+ +-+-+ + + +
|     |   | | |   |       |   |   |   |   |   | | |
+-+ +-+-+ + + +-+-+-+-+ + +-+ + +-+-+ + + + + + +-+
|   |   |         |     |       |   |   |   |     |
+ +-+ + + + +-+-+-+ +-+-+-+ +-+-+ + + +-+-+-+ +-+-+
|     |   |   |     |         |   |         |     |
+ + +-+-+-+-+ +-+ + + +-+ +-+ + +-+-+ +-+ +-+ + + +
| | | | | |   |   | |     |         |       | | | |
+ +-+ + + +-+ +-+-+ +-+-+ + +-+ +-+ + + + + + + + +
|         |               |   | |     | | |   | | |
+-+-+-+-+-+-+-+-+-+-+-+-+-+-+-+-+-+-+-+-+-+-+-+-+-+
