+-+-+-+-+-+-+-+-+-+-+-+-+-+-+-+-+-+-+-+-+-+-+-+-+-+
|           | |   |     |         | | |   |   |   |
+ +-+-+-+-+-+ +-+ +-+ +-+-+-+-+ + + + + +-+-+ +-+ +
|           |       |         | |             |   |
+-+-+-+ +-+ + +-+ +-+ +-+-+-+ + +-+ +-+-+-+-+-+ +-+
|   |       | |   |     | |       |       | | |   |
+-+ + + +-+ + +-+ + +-+-+ + + + + + +-+-+-+ + + +-+
| | | | |     |             | | |   |   | |       |
+ + + +-+ + +-+ + +-+ +-+-+ +-+-+ +-+ +-+ + +-+ + +
|       | | |   |         | |     |   |         | |
+ + +-+ +-+ +-+-+-+ + +-+-+ + +-+-+ + +-+ +-+-+ +-+
| | |   | |   |     |           |   |             |
+-+ +-+-+ +-+-+-+ +-+ + +-+-+-+ +-+ +-+-+ +-+-+ +-+
| | |   |             |   |   |             |     |
+ + +-+ +-+ +-+-+-+ +-+ + + + + +-+ +-+ + +-+-+ +-+
|     |   |     |     | |   | | |       |         |
+-+-+ + + +-+-+-+-+ +-+-+ +-+ + +-+-+-+-+-+ +-+ +-+
|       |       |           |         | |     |   |
+-+ +-+-+ + +-+-+ +-+ +-+-+ +-+ +-+ + + +-+-+ +-+-+
|   |     | |         |     |     | |         |   |
+-+-+ +-+ + + +-+-+ +-+ + + + + +-+ + +-+-+ +-+ +-+
|   | | |           |   | | | | |   | | |         |
+-+ + + +-+-+-+-+-+ + + +-+ + +-+ + +-+ + +-+-+-+ +
|             |   | | |         | | |   | |       |
+-+-+ +-+-+-+ +-+ + +-+ + +-+ +-+-+ + +-+ + + +-+-+
|           |         | |   |   |       |   |     |
+ +-+ + + + +-+-+ +-+ +-+ +-+-+-+ +-+ + + +-+ +-+ +
|     | | |     | |     |   | |       |         | |
+ + +-+-+-+-+-+ + +-+ +-+-+-+ +-+ +-+-+ +-+ +-+-+ +
| | |   | | | |     |   |     | |   |     |       |
+-+ + +-+ + + + +-+-+-+ + +-+ + + +-+ +-+ +-+ +-+-+
|         |   | |   |     |   |         |         |
+-+-+ + +-+-+ + +-+ +-+ + + +-+-+-+ +-+ + +-+ +-+-+
|     | |           |   | |       | |     |       |
+ + +-+ +-+ +-+-+ +-+-+-+ + +-+-+ + +-+ +-+-+-+ + +
| |     |       |   |       | |     | | |       | |
+ +-+-+ + +-+-+ +-+ + +-+-+ + +-+ + + +-+-+ +-+-+ +
|   |   | |     |         |   |   |     |     | | |
+-+ + + +-+-+ +-+-+-+ + +-+ +-+ +-+-+-+ +-+ +-+ + +
|   | |               | |         |     | |   | | |
+-+ + +-+ +-+-+-+-+-+-+ + +-+-+-+ + +-+ + +-+ + +-+
|   |       | | |     |         |   | |   | |   | |
+ +-+ +-+-+ + + + + +-+-+-+ +-+-+ +-+ +-+ + + + + +
|     | |         |       |   | |             |   |
+ + +-+ + +-+ +-+ +-+ +-+-+ +-+ +-+-+ +-+-+-+-+ + +
| |       | |             | |       | |     | | | |
+-+ +-+ + + +-+ + +-+-+ + + + +-+ +-+ +-+ +-+ + + +
|       |   |   | |     |       | |   |         | |
+ +-+ +-+ + +-+-+-+-+ +-+-+ + +-+-+ + + +-+-+-+ +-+
| |   |   | |             | |       | |     |     |
+-+-+-+-+-+-+-+-+-+-+-+-+-+-+-+-+-+-+-+-+-+-+-+-+-+
